诗	詩
杨	楊
译	訳
兰	蘭
凤	鳳
韦	韋
吴	呉
赵	趙
贾	賈
爹	黐
韩	韓
萧	蕭
萨	薩
姊	姉
倘	麪
乔	麕
冯	馮
舰	艦
讯	訊
迁	遷
订	訂
庙	廟
鸿	鴻
鹏	鵬
怔	鵯
兹	茲
辆	輌
枫	楓
阐	闡
锦	錦
琼	瓊
邮	郵
婷	鵆
鹰	鷹
币	幣
斋	斎
沪	滬
歧	鵄
仑	侖
晌	鴪
驶	駛
邓	鴈
亿	億
骇	駭
渔	漁
煞	鱧
轩	軒
锡	錫
谊	誼
沧	滄
诵	誦
谭	譚
坟	墳
荆	荊
俞	兪
诧	詫
钗	釵
聂	聶
颖	穎
钥	鑰
侄	姪
陡	闘
贩	販
叁	鰔
厢	廂
尧	尭
轿	轎
芷	鯱
缕	縷
秃	禿
娱	娯
栋	棟
钰	鯒
鲍	鮑
矿	鉱
郝	鯑
桢	鯏
缪	繆
霉	黴
绮	綺
岚	嵐
鸳	鴛
驴	驢
舆	輿
庐	廬
阎	閻
诊	診
舱	艙
顷	頃
鸭	鴨
觅	覓
骏	駿
贷	貸
诈	鬥
詹	鬆
冈	岡
琪	髷
钞	鈔
巩	鞏
鸯	鴦
稣	髴
怅	悵
筷	髣
蓦	驀
鹊	鵲
莺	鴬
啤	體
窦	竇
铮	驅
鸠	鳩
拣	騷
揪	駮
陕	陜
琏	饑
垄	壟
诬	誣
滨	濱
诛	誅
祯	禎
筠	饂
芜	蕪
颐	頤
辫	辮
姗	餬
阀	閥
宓	餠
摹	餤
薰	薫
笃	篤
砚	硯
龚	颱
煜	顋
帧	幀
侨	僑
箫	簫
鹃	鵑
扳	鈑
蝇	蝿
绎	繹
圳	韲
炜	韈
诠	詮
锥	錐
渲	鞦
颁	頒
谛	諦
狞	獰
聋	聾
衮	袞
诃	訶
橱	鞜
睬	靺
沅	靹
泸	瀘
谕	諭
鳄	鰐
闵	閔
珑	瓏
谏	諌
婧	靈
跄	蹌
娓	靆
迳	逕
兑	兌
惋	輓
唬	雜
讼	訟
雯	隸
鬓	鬢
阙	闕
贿	賄
轼	軾
抨	陝
嬷	陞
浒	滸
闽	陏
鞑	韃
恺	關
邢	閠
娄	婁
踱	鈬
鸽	鴿
飕	閖
汴	閊
讪	閇
驿	駅
篱	籬
萤	蛍
辗	輾
婶	鑽
谟	謨
缴	鑵
俨	儼
栈	桟
谤	謗
灶	竃
诣	詣
俭	倹
踹	鑪
栅	柵
馒	饅
辖	轄
枣	棗
袅	嫋
钊	鑛
婊	鑁
盎	鐡
阑	闌
纨	鐵
缅	緬
佬	鐶
韬	韜
炕	鐓
亩	畝
缭	繚
绛	絳
诲	誨
槛	檻
坞	塢
碳	鏝
纣	紂
铐	鎹
渎	涜
谍	諜
坷	鎔
邹	鄒
讹	訛
铎	鐸
蔷	薔
浏	瀏
榷	鎭
隽	雋
恻	惻
纭	紜
嬴	鍮
萦	鍼
钮	鍜
纬	緯
狰	錻
榆	楡
锣	鑼
缉	緝
蹑	躡
掳	錵
簌	錺
绥	綏
驹	駒
蛊	蠱
湄	鋩
鸥	鴎
锄	鋤
崽	銕
骷	鉈
忡	鉅
袄	襖
诘	詰
贻	貽
雳	靂
烬	燼
苇	葦
茧	繭
颉	頡
褚	釼
砆	釛
碔	釡
钳	鉗
阖	闔
诂	詁
绫	綾
鲸	鯨
蕙	釋
璜	醯
嵇	酳
缰	酘
轶	軼
烨	酖
怆	愴
髅	髏
涧	澗
烩	邉
偌	遲
跺	隨
毡	氈
玺	璽
辕	轅
绚	絢
飙	飆
赃	賍
瑷	遯
憨	遞
诽	誹
骡	騾
缥	縹
荃	遖
擎	遉
楣	逎
癞	癩
乓	逧
籁	藾
窑	窯
晗	迴
悻	邇
跷	磽
濒	瀕
琦	迯
睽	迚
滢	辷
骈	駢
忒	辭
镑	轣
雏	雛
伫	佇
缈	緲
匾	轜
炅	轗
鲨	鯊
谙	諳
戾	輹
谆	諄
矶	磯
霭	靄
飒	颯
谪	謫
痪	渙
跤	輛
礴	軈
屿	嶼
赂	賂
涔	軅
纾	軆
鸾	鸞
贰	貳
翟	躔
纶	綸
抡	躄
鹦	鸚
闸	閘
滤	濾
胭	蹐
镯	踴
陇	踰
恸	慟
墩	踐
枭	梟
贮	貯
瘪	跿
惦	踈
缨	纓
攥	跼
靶	赱
姒	贔
潆	贓
夔	贊
匮	匱
脍	膾
汩	賻
辍	輟
锭	錠
睐	賣
欤	歟
翎	賤
挞	撻
讷	訥
饲	飼
邺	戝
脓	膿
钏	釧
洼	貍
诙	詼
缆	纜
霁	霽
饺	餃
殡	殯
荧	塋
闩	閂
鹗	鶚
锚	錨
缤	繽
锵	鏘
弈	豬
陨	隕
驸	豎
晾	谺
撂	讙
阉	閹
泾	讀
蓓	譽
璇	譯
缄	緘
缜	譟
卤	鹵
饷	餉
荤	葷
懵	譖
辐	輻
惬	證
炖	燉
谥	謚
谗	譁
罡	謠
鹉	鵡
涣	諡
镣	鐐
绀	紺
掂	諫
膑	諚
峦	巒
茬	靫
滇	觝
菀	觀
靳	覽
猬	蝟
篓	簍
虬	覺
垅	覈
垦	襷
鼢	襴
鹫	鷲
怂	慫
汶	襭
懑	懣
觞	觴
阕	褝
牍	牘
琨	褞
鲤	鯉
樨	褌
撵	褄
甭	裲
媲	裝
讴	謳
轲	軻
拄	袰
蘸	袮
熠	袗
镰	鎌
谄	諂
荪	袵
鹂	衞
栾	欒
荔	衒
馁	餒
骥	驥
峒	衂
骁	驍
桅	衄
毗	蠻
瘸	蠧
饯	餞
窠	蠶
抠	蠑
剐	蠎
斓	蠍
犷	蠏
颍	潁
稹	蟲
囱	蟇
琛	蟐
靓	螢
蛐	蠅
呓	囈
刨	蝪
岖	嶇
捋	蜑
闾	閭
勰	蛬
骧	蠣
刽	蚰
榭	號
啕	乕
羿	虍
鹭	鷺
捎	蘋
婺	蘓
焘	藥
谀	諛
镐	薹
颦	顰
崆	蕷
镂	鏤
掇	薑
戕	薀
熵	蕀
龛	龕
恿	慂
璀	蔕
诌	蔟
骞	騫
鸪	鴣
胰	蓆
妪	嫗
娣	蒻
榄	欖
泞	濘
坳	蓙
侬	蒟
炀	煬
皑	皚
娲	葢
辇	輦
鳖	葹
骊	驪
鹧	鷓
姝	葯
饨	飩
腌	萬
辘	轆
婕	葮
撷	蒄
暨	曁
绾	綰
铨	銓
钺	鉞
俪	儷
昙	曇
驮	駄
赡	贍
嵘	萪
孪	菻
傥	儻
驷	駟
跻	躋
淄	蔆
淖	萠
佟	萢
虢	菷
峥	崢
砭	菎
桦	枠
璨	菫
擞	萓
昕	菴
贽	贄
蹿	荳
鹄	鵠
谶	讖
倌	莵
嫔	嬪
磷	莇
镌	鐫
獠	茣
挎	莖
氲	莟
龇	莚
闰	閏
胫	脛
诰	誥
摞	茘
谲	譎
怵	艸
馄	鯤
庾	艷
溉	漑
荟	薈
殇	殤
摈	擯
俅	艪
睑	瞼
觎	覦
镳	艢
刍	芻
嬗	艟
磺	艚
犊	犢
锲	艝
绶	綬
郸	鄲
蜓	艀
莘	舩
漳	舖
鸨	鴇
殁	歿
铉	與
鹳	鸛
槟	檳
坨	臟
觊	覬
饬	飭
堑	塹
灏	臈
闳	臙
颢	臑
琮	膽
蟑	膵
榈	櫚
贲	賁
膻	羶
鸢	鳶
掸	腟
绉	膣
泠	膤
偻	膕
碉	膃
诨	諢
盅	腦
睢	脣
臃	脩
蹩	肬
嶙	冐
仨	聽
赣	聹
绌	聰
扪	捫
峋	聨
祜	聢
镀	鍍
颚	顎
倜	聟
镬	耡
鹪	鷦
靥	靨
圯	飜
叵	翆
揿	譱
茁	羮
仃	羣
剜	羃
铢	銖
鑫	羂
篙	罸
氢	輕
泵	罧
罂	罌
蓟	薊
卟	罠
芮	罎
骅	纎
辔	轡
赊	纖
苯	纔
徜	纒
鹘	鶻
邕	續
坯	繿
潢	緕
菡	纃
歆	繻
芊	繩
踮	鈿
碱	繪
鬃	繙
籽	繖
牯	繧
鲧	鯀
聩	繦
颏	縱
跎	縒
埂	縣
诮	誚
镛	緻
飓	颶
铀	綟
殓	緜
殒	殞
徉	綯
侩	總
昀	綵
锴	綛
箩	絽
煲	襃
徕	徠
焱	經
岜	絣
飨	饗
缙	縉
邈	絖
铝	紵
钙	紮
诟	詬
鼹	糺
凫	鳬
骛	糴
缢	縊
傣	糒
鹜	鶩
淼	糂
锹	鍬
呤	糀
滟	粨
踽	粡
聃	粫
钿	粢
炷	粭
杈	粐
浃	浹
赅	籵
晔	曄
讦	訐
旎	籖
恹	籤
玮	籟
焯	籘
轸	軫
奁	奩
玟	籐
跆	籏
恽	籔
钎	篶
鸵	鴕
橐	簗
蘅	簓
灞	簀
藓	蘚
殚	殫
诿	籠
侪	儕
忾	愾
旖	簔
趄	簑
缛	縟
矸	篏
绡	箙
帏	幃
碴	箏
祛	箒
谌	箚
鼐	箟
銮	鑾
瘀	箘
狯	獪
裱	筰
囫	筅
罄	筍
嘹	筺
骓	騅
囵	笶
牖	笵
阗	笂
瓯	甌
蚱	竢
遛	竡
樾	竝
痨	竚
蒯	竓
堇	竏
誊	謄
讫	訖
诳	誑
馊	竍
郦	竊
螅	窰
俦	儔
鲲	竈
膘	穽
韪	龝
悱	穩
桠	椏
乩	穉
衩	穃
姘	稾
怄	稱
钠	稟
醮	稙
溧	稘
铄	鑠
颧	顴
畹	秡
浔	潯
栊	槞
觥	禮
氯	禪
锏	繝
赝	贋
缮	繕
秸	禝
疟	瘧
缦	縵
馍	祿
钤	礙
箧	篋
鄱	礑
赁	賃
雠	讎
飏	礒
趔	礇
铖	磚
奂	奐
傩	儺
迨	磑
蔺	藺
篑	簣
婵	嬋
氖	碯
獐	碪
赈	賑
缁	緇
烜	碵
绺	碆
侗	硴
镗	礪
邝	砠
飚	礦
擤	矼
涿	矇
饴	飴
骠	瞹
闱	瞶
骢	眛
橹	眥
酮	眞
谯	眤
颀	盻
馏	餾
诤	蘯
烊	盪
荚	莢
煨	盡
囡	皹
琰	皃
啭	囀
鸩	鴆
绦	絛
掼	皀
鳅	鰍
讧	訌
遴	癶
媪	媼
蔻	癪
镭	癨
簦	癢
纥	癡
鲈	鱸
澍	癜
摭	癈
穑	穡
诓	瘻
屣	瘉
荦	犖
钹	痳
玎	痲
茈	痃
囤	疳
怼	疂
栉	櫛
蝼	螻
劢	疉
邛	疊
昱	疇
镊	鑷
瓴	當
汜	畭
蹰	畫
芾	畧
缟	縞
谖	畩
椠	槧
镫	畆
珏	畉
犟	畊
殛	畍
妫	畄
樯	檣
纰	紕
龃	齟
鱿	尢
锌	甼
濑	瀬
骜	甦
峤	甞
丏	甕
鄢	甅
毂	轂
夯	甃
碜	瓸
龉	齬
讣	訃
哙	瓱
崧	瓰
蕤	瓩
苕	瓧
蕻	瓔
蝈	幗
唁	珸
臬	瑯
篾	璢
佥	僉
逦	獻
锉	獵
蜇	獨
魉	魎
栀	梔
蔫	猯
喑	狹
酶	狆
胺	犲
莼	蓴
鹑	鶉
趼	犧
獭	獺
庋	犇
赓	犂
鸱	鴟
繇	牴
儆	牋
绻	綣
饽	牀
艄	爼
讵	爲
铡	爭
趿	爐
蒺	燿
颛	燵
荠	薺
嘏	燬
娈	燒
骘	隲
岘	燗
鬈	熕
锩	燻
纡	紆
秆	稈
黩	黷
棂	櫺
埙	煖
顼	熈
帼	煕
锷	鍔
祂	烋
诒	詒
缱	灣
鸷	鷙
馑	饉
鳗	鰻
暍	灑
茕	煢
骐	騏
郴	瀰
狲	瀁
髡	瀋
谔	諤
猢	濔
焊	駻
伧	濕
淝	濟
踯	躑
赍	齎
谡	謖
轫	澪
靛	濆
廪	廩
猱	澣
抟	摶
渌	澑
镞	鏃
瓒	潛
钾	澁
砝	滷
铩	滯
酰	滉
挹	溂
碛	磧
掮	滿
洚	渟
蜢	湶
煊	淕
洱	淺
驽	駑
喁	淒
邬	渕
捭	濤
鳏	鰥
谝	諞
耦	浤
镔	洳
餍	洟
觏	覯
妤	泙
鲫	沺
璩	泝
毽	沒
筚	篳
铰	沚
姹	沍
秾	汢
潞	氣
竽	毬
撺	毟
枰	毆
莒	殼
氮	殲
阊	殪
庑	廡
阆	殕
珩	殘
犄	殀
獾	歸
猡	歡
摀	歐
勖	飮
崴	盜
锱	錙
莆	欟
孬	鬱
辋	欅
茏	蘢
阄	鬮
伥	櫻
焖	櫟
乜	櫑
訇	櫞
佘	蘗
阏	閼
饫	飫
滦	檢
砉	檍
鹞	鷂
蜮	樢
訾	樸
嫫	橸
锃	樶
谠	橲
悭	慳
钡	樌
绔	樓
汛	櫁
雒	樒
觋	覡
氐	槫
瑭	樔
荞	蕎
龢	槭
诔	誄
榫	樞
綦	槹
夤	權
鲠	樛
兖	樂
滁	槨
荑	榠
泮	榑
朓	樮
邳	槝
挝	榾
佤	槓
橛	榿
撄	榮
彀	榲
仵	楪
荛	蕘
栎	檪
圮	榁
崤	楙
郜	楴
逯	椹
铳	銃
犍	楾
剡	楜
轾	輊
郇	棆
杌	椡
蕲	椣
涪	椚
荨	蕁
狻	椪
阒	闃
牦	椨
缒	縋
荥	棯
扃	椥
洄	椄
黢	齲
辏	椶
畀	棧
嚭	棔
沤	椌
癣	癬
洹	棡
琊	椢
蠲	椈
桡	橈
瓤	棊
怃	憮
沆	梍
泫	梺
鲛	鮫
骝	梠
蚍	梹
亍	檮
旮	條
砣	桿
疡	瘍
帔	桙
猕	栫
呖	桍
骖	驂
疴	痾
懔	懍
崐	栞
郓	檜
刿	柧
舢	柆
缃	柎
桉	枹
赀	貲
屺	柮
癯	柤
龋	枴
搠	枅
铣	銑
冼	枡
辎	輜
胪	臚
矾	礬
堞	枦
茔	枌
橥	枩
氅	杤
沔	杣
镁	杙
澶	朷
觯	朸
阃	杁
娌	朿
嫘	朮
喈	朞
鼍	朖
泷	滝
鲇	鮎
粑	朏
偓	曵
殽	曠
蘼	曚
厝	暸
俇	暼
鼙	曉
侔	暘
戆	暎
墉	暃
虺	晢
椤	晧
旯	晝
岿	晉
酽	晄
擀	昜
鹌	旡
硌	旙
聱	旛
垆	斷
鳝	變
妯	斂
飧	喰
馐	數
阋	鬩
韫	敘
焐	敍
暌	攷
蚝	攴
笤	攜
锟	擽
髹	擴
轭	軛
藿	擶
赜	擡
芰	舉
畲	擧
傧	據
嫽	攪
猓	摎
脔	臠
潋	瀲
伛	傴
羼	搨
珰	搗
郅	攝
鲵	鯢
鳍	鰭
坼	搆
坻	搖
琬	掵
痫	癇
鲂	魴
洇	掟
阈	閾
烷	掫
锰	掎
枥	櫪
惝	挾
铙	鐃
痱	拵
鄯	挧
愦	挌
苌	萇
痈	癰
璎	珱
顸	擔
鳎	拑
珉	抃
碘	抂
趸	扨
洮	扠
翮	扞
苎	苧
瑗	戲
氡	戞
芡	戀
蚜	懼
锨	懽
朊	懺
媸	憺
鋈	懆
彘	懷
郧	應
缣	憑
曛	憇
茀	憖
嬛	憙
潍	慓
伢	慱
颟	慥
佾	慯
谰	慴
搿	慙
笾	慘
豳	慄
轱	愽
戋	戔
舨	愼
蕖	惱
闼	闥
裰	愡
浞	愃
诎	惷
妗	悽
囝	忰
炔	惓
踬	躓
葚	惡
窳	悋
窣	悧
绂	悗
邗	悁
髌	恆
戢	恊
邶	恟
兕	恷
鹬	鷸
蕡	怺
缗	緡
楂	怐
屙	恠
饧	悳
氰	從
掊	徑
鎏	彿
辂	輅
烯	徃
狺	彡
墀	彙
戗	彑
崂	彎
晷	彌
遄	彈
蘧	彁
罴	羆
隳	弸
媵	弖
鸬	彜
捃	弉
傈	廸
渑	廴
酆	廰
椟	廳
睃	廱
鞯	廢
缇	廚
葳	廝
酹	廐
诼	廈
嫠	廁
狍	幵
鳃	鰓
裒	幤
悝	幎
黾	黽
毖	帶
唣	帋
澧	巵
圩	巛
鸶	巖
枘	巉
荇	嶐
瀣	嶽
狁	嶮
螭	嶬
幛	嶝
踔	嵶
棻	嵳
蟊	嵎
锒	嵒
铗	鋏
蛱	崘
阍	崚
陔	崑
麂	崟
酡	嵜
棰	崕
伕	崋
辚	嶌
谳	峺
祧	峽
鍪	峩
莴	萵
邾	峇
迕	岾
颃	頏
獒	峅
郏	岼
邙	岶
龅	岻
涞	妛
疠	癘
舄	潟
褰	屶
莳	蒔
璟	乢
禛	屮
垭	屬
铧	屓
铬	屆
觇	覘
赉	賚
蟮	尨
凇	尓
幂	冪
迮	對
镒	鎰
鲋	鮒
蛴	專
蝰	將
饔	尅
轳	轤
咴	寳
谵	譫
鹈	鵜
齑	齏
鄜	寶
厍	寫
褡	寢
跸	蹕
荩	實
洎	寉
麇	寃
絷	斈
僳	學
芗	孅
酚	竕
骀	駘
蕞	孃
溆	嬾
鳕	鱈
爝	嬶
峄	嫐
粜	糶
瓿	嫺
颙	娵
沣	婬
郯	娚
盱	姙
峁	侫
鸹	妝
琯	奬
艿	奧
茍	竒
墒	夲
薏	夬
舻	艫
缑	夛
谮	譛
驺	夐
鹚	壽
踅	壼
眬	壻
怿	懌
屄	壺
鹆	壯
犴	壜
儋	壥
逄	壘
嫱	壗
迓	壓
侂	墮
秫	墸
滹	墻
蔌	壞
澌	墫
洧	墹
缯	堽
扦	塰
裎	塲
邠	堝
镏	埣
琚	埖
秭	埓
錾	鏨
棼	埆
戬	垪
枨	垤
葸	垳
漭	垉
荸	坿
馕	垈
铆	鉚
堠	埀
濉	坩
葑	圸
璘	圷
蹓	圦
鳟	鱒
氟	團
圹	壙
榉	圍
伲	國
锞	圀
珐	琺
豉	囮
鄞	囓
溱	囑
诜	囎
悫	愨
芩	囃
跽	嚴
硎	嚮
鹕	嚥
肏	嚔
蠓	嚠
麀	嚊
缡	營
剀	剴
揎	噐
瘐	嗹
呙	咼
绲	喨
酴	單
屦	啝
芈	唸
蚴	啗
埽	啅
诖	啌
跶	啣
浥	啀
菔	唹
痖	哘
鲣	鰹
瘗	咾
蛳	咥
镝	鏑
埸	咢
雩	呰
虿	呟
笱	吽
鹓	叺
煅	雙
郾	厰
刭	剄
泚	卻
籼	夘
挢	卩
觌	覿
砷	凖
肽	卍
尕	丗
镍	卆
臁	區
绁	紲
糁	匸
郫	匳
湜	勹
鹩	鷯
蚨	勸
芃	勵
缵	纉
铱	勳
鲞	勠
窆	勦
敉	勣
菏	勞
萁	勗
湣	勍
筇	劵
瞀	劼
笫	辧
黧	劑
腚	剱
勐	劒
觱	劔
皤	劍
瘼	剳
笕	筧
嵊	剋
姮	剏
痤	刧
匄	刔
闶	刋
鲆	鮃
阚	刄
蒉	凾
吣	凵
珲	琿
蟪	凩
窸	處
邰	凅
蠛	冱
痧	冫
锛	冩
埤	冦
殂	冖
趵	冓
鄄	冑
熳	冏
癔	囘
锸	冂
珙	兩
箓	竸
蘩	兒
鏊	儚
鲔	鮪
恧	儖
簏	儁
枞	樅
咮	儉
哏	價
仳	僣
岵	僞
炝	傳
裣	傚
颡	偖
昉	偐
苁	會
鼯	伜
荜	倅
翚	俥
鹁	俤
奡	俛
獯	俔
黟	儘
礌	來
栘	侘
摅	仭
黡	黶
忮	仂
刖	亰
侉	亠
稞	亞
锼	弍
瘛	亊
汊	亅
醅	乂
踣	丿
庥	丼
缫	丶
钲	鉦
愔	丱
菹	弌
廑	椀
撙	亙
舣	艤
椐	錬
哕	憐
闫	暦
锶	隷
濞	涙
龆	齠
缳	瑠
谂	糧
氚	稜
塍	瞭
箨	涼
倮	葎
阌	裡
镪	裏
厣	慾
芑	葉
缧	縲
帻	猶
郗	湧
钋	癒
柽	鑓
岀	匁
脞	籾
氦	戻
糍	杢
棨	黙
鄣	網
逭	麺
忭	無
钍	夢
眙	粍
羑	脈
慆	麿
觫	侭
邲	桝
眚	柾
硖	槙
搛	釦
獬	僕
岢	鉾
徬	豊
轺	砲
蒗	峯
绱	穂
诹	諏
攮	鋪
稊	辺
湔	箆
蜾	塀
煳	併
釄	雰
钴	鈷
饩	仏
莸	蕕
鳜	払
憯	淵
虼	複
璠	鋲
祎	氷
髁	俵
桕	柊
憷	毘
砀	樋
贶	釆
鲱	鯡
僦	範
鲥	汎
魈	氾
觔	塙
荽	噺
熘	抜
崾	醗
桬	発
搧	畠
遹	畑
孓	筈
昺	硲
砻	萩
囟	楳
笪	盃
垡	拝
佺	覇
酤	覗
晬	廼
偾	禰
蹁	韮
骎	駸
柒	匂
叻	弐
贳	貰
艹	畷
糇	楢
枵	薙
腭	齶
锜	瀞
忉	椴
舡	栃
胗	峠
泐	働
浼	燈
艏	梼
斁	嶋
跗	兎
劂	澱
涑	紬
鹨	嬬
跩	辻
闿	槻
蒌	栂
蹀	塚
趱	鎚
绠	捗
崃	勅
柙	銚
瘳	聴
歊	徴
嘒	彫
沬	弔
箬	瀦
酯	酎
馓	註
茭	築
獍	恥
锑	歎
甙	蛸
皲	皸
煸	凧
芪	託
鹖	択
萏	瀧
苷	辿
鲷	鯛
慉	騨
嫪	楕
嗌	詑
毐	揃
蚧	蔵
朐	鎗
湓	荘
陉	窓
蛏	蟶
谫	捜
畈	惣
锳	遡
埏	疎
旰	曽
芨	岨
瞢	糎
芄	薦
鹇	栴
仡	蹟
挼	跡
埘	塒
倊	隻
窨	製
湑	棲
醛	摺
沭	椙
芏	髄
囷	酔
硷	粋
哚	醸
汔	譲
铂	穣
猃	壌
窭	窶
涘	乗
嵝	鍾
伃	衝
缬	纈
莜	昇
珦	廠
豨	藷
绨	準
锬	楯
鞮	従
趑	醜
跬	週
劓	讐
螨	蒐
皦	繍
氵	収
锗	呪
嗐	捨
疃	舎
肷	偲
镠	鏐
硐	篠
焓	蔀
俜	雫
钛	宍
玠	鴫
倓	児
鄘	諮
驵	誌
苋	糸
狶	屍
芤	讃
傺	錆
骱	鯖
薅	皐
钭	冊
粝	糲
鞒	笹
尥	碕
樘	埼
筲	榊
钕	堺
沩	冴
榇	砕
猰	瑳
裥	込
砟	狛
骟	穀
醁	麹
崦	閤
嫒	砿
痀	紘
螬	広
绐	紿
甏	効
蔾	檎
蛘	後
鲟	個
缂	絃
楦	捲
揸	圏
悰	決
镆	傑
旐	罫
珧	繋
鳣	渓
啴	恵
肫	係
玕	繰
猹	粂
菑	駈
摽	粁
坫	脅
糨	況
絜	兇
钒	禦
疖	拠
瀼	喫
檩	気
锔	機
菪	棄
蛲	蟯
肟	幾
芎	願
嗍	翫
蚵	巌
瘆	舘
猞	陥
栌	櫨
腩	潅
苤	幹
晡	姦
锓	巻
骍	乾
钚	苅
钨	栢
孢	蚫
裢	鞄
琎	樺
轵	椛
栝	橿
螓	樫
鬒	掛
裀	穫
怍	浬
鲅	蓋
砹	廻
虮	壊
茑	蔦
嘌	菓
玦	箇
艋	価
骶	仮
赟	贇
馇	沖
矬	薗
鲒	煙
骙	詠
畯	榎
鲦	頴
掹	洩
棬	叡
峣	嶢
喤	雲
猁	噂
揠	欝
胂	韻
蠊	鰯
鞲	稲
镈	壱
砊	扱
蚬	蜆
崞	鯵
胨	姶
鲙	鱠
